WWWWWWWWWW
WK $N$  MW
WM  l   KW
WK      MW
WM      KW
WK      MW
WM      KW
WK  H   MW
WM  8   KW
WWWWWWWWWW