WWWW0WWwwW
W:g   S:cW
W:s  WWWWW
W:     Gbw
wWWW B g W
Wb:     :W
W:C   TWwW
WWW     :W
Wb: g   :W
WWWWHWWWWW
    9