WWWW0WWWWW
W::c c:::W
W:gC   g:w
w:g    g:W
W:g    g:W
W:g    g:W
W:g    g:W
W:::H::::W
Wbbbbbbbbw
WWWWWWWWWW