WWWW5WWWWW
Wb......bW
Wb:$&$ :bw
Wb:    :bW
WbS    Sbw
Wb:    :bW
Wb:    :bw
Wb:    :bW
Wb:g gg:bW
WWWWHWWWWW
    9