WWWW0WWWWW
Wh      gW
W  B     w
WwWWW  s W
W   W    W
W   W  WWW
W 8H   g W
w        W
W  g  C  W
WWWWWWWWWW
