WWWW0WWwwW
W g     gW
W  B   T W
3      G w
w      g W
W T    W W
W C   :W W
W      W 1
W  g   W:W
WWWWHWWWWW
    9