WWWWwWWWWW
WbbbbbbbbW
W........W
w       hw
W     S $W
2H    C cW
W     S $W
W........w
WbbbbbbbbW
WWWWWwwWWW