WWWWWWWWWW
WgWggggwgW
Wg  &  sgW
wg      gw
wgB    BgW
WgB    BgW
WgB    BgW
WgG     gw
Wgw    WgW
WWWWHWWWWW
    9