WWWW5WWWWW
W..$ $...W
WB     h w
WwWWW   SW
W       gw
WC  WwwWWW
W  g     H4
W........W
WbbbbbbbbW
WWWWWWWWWW