WWWW5WWWWW
Www$.$wwwW
Www:. wwwW
Www:. wwwW
Www . wwwW
Www .:wwwW
Www . wwwW
Www . wwwW
Www . wwwW
WWWWHWWWWW
    6