WWWW0WWwwW
Wwww wwwwW
Ww:   cwwW
ww ...Swww
Ww ... wwW
2H ...BwwW
Ww   : wwW
WwwwwwwwwW
WbbbbbbwwW
WWWWWWWwwW