WWWWWWWWWW
WwWbbbbwwW
Wwg & hgwW
wwC    Cww
wwC    CwW
WwC    CwW
Wwg    gwW
Wwg    gww
Wwwb  bWwW
WWWWHWWWWW
    9