WWWWWWWWWW
WwWbbbbwwW
Wwg & GgwW
wwB    Bww
wwB    BwW
WwB    BwW
Wwg    gwW
Wwg    gww
Wwwb  bWwW
WWWWHWWWWW
    9