WWWWWWWWWW
WW  .: gWW
W  $.$   W
W...7....W
W  $.$:  W
Wg: .  ggW
Wgg .:gggW
Wgg . gggW
WWg$.$ggWW
WWWWHWWWWW
    6