WWWW5WWWWW
Wbb  gbbbW
W$: .GwwwW
3   .SwwwW
W$: .SwwwW
Www . wwwW
Www   wwwW
Wwww    g1
Wwwwg wwwW
WWWWHWWWWW
    9