WWWWWWWWWW
WWgg.gggWW
Wgg$.$gggW
W...7....W
Wgg$.$gggW
Wggg.ggggW
Wggg.ggggW
Wggg.ggggW
WWg$.$ggWW
WWWWHWWWWW
    6